..........
......#...
@.....@...
.@........
..........
..........
@...@.....
.......@..
##........
..........
